const_code,constituency,win_party,win_votes,second_party,second_votes,margin,percent
1,Behat,BSP,70274,INC,69760,514,0.23
2,Nakur,BSP,89187,INC,84623,4564,1.98
3,Saharanpur Nagar,BJP,85170,INC,72544,12626,5.75
4,Saharanpur,BSP,80670,INC,63557,17113,8.39
5,Deoband,SP,66682,BSP,63632,3050,1.56
6,Rampur Maniharan,BSP,77274,INC,50668,26606,13.61
7,Gangoh,INC,65149,SP,61126,4023,1.76
8,Kairana,BJP,80293,BSP,60750,19543,10.99
9,Thana Bhawan,BJP,53719,RLD,53454,265,0.15
10,Shamli,INC,53947,SP,50206,3741,2.22
11,Budhana,SP,68210,RLD,57622,10588,5.5
12,Charthawal,BSP,53481,BJP,40775,12706,7.37
13,Purqazi,BSP,53491,INC,44583,8908,5.32
14,Muzaffarnagar,SP,59169,BJP,44167,15002,8.86
15,Khatauli,RLD,46722,BSP,40847,5875,3.45
16,Meerapur,BSP,56802,RLD,44069,12733,7.55
17,Najibabad,BSP,62713,BJP,51130,11583,6.19
18,Nagina,SP,83997,BSP,57451,26546,14.55
19,Barhapur,BSP,68436,BJP,41061,27375,13.53
20,Dhampur,SP,53365,BSP,52801,564,0.35
21,Nehtaur,BSP,51389,SP,31991,19398,11.8
22,Bijnor,BJP,68969,BSP,51133,17836,8.52
23,Chandpur,BSP,54941,SP,39928,15013,7.98
24,Noorpur,BJP,47566,BSP,42093,5473,3.1
25,Kanth,PECP,37092,BSP,35558,1534,0.76
26,Thakurdwara,BJP,84530,MD,46556,37974,17.24
27,Moradabad Rural,SP,72213,BJP,49477,22736,12.59
28,Moradabad Nagar,SP,88341,BJP,68103,20238,9.66
29,Kundarki,SP,81302,BJP,64101,17201,7.84
30,Bilari,SP,55694,BSP,54154,1540,0.81
31,Chandausi,SP,55871,BJP,51864,4007,2.09
32,Asmoli,SP,73873,BSP,47484,26389,12.63
33,Sambhal,SP,79820,BJP,49773,30047,15.32
34,Suar,INC,55469,BJP,41754,13715,8.22
35,Chamraua,BSP,37083,SP,35237,1846,1.12
36,Bilaspur,INC,52818,SP,42641,10177,5.24
37,Rampur,SP,95772,INC,32503,63269,36.54
38,Milak,SP,56798,INC,36635,20163,11.2
39,Dhanaura,SP,55545,BSP,47916,7629,3.9
40,Naugawan Sadat,SP,55626,BSP,51964,3662,1.81
41,Amroha,SP,60807,BJP,39002,21805,12.34
42,Hasanpur,SP,92843,BSP,60615,32228,14.6
43,Siwalkhas,SP,58852,RLD,55265,3587,1.91
44,Sardhana,BJP,62438,RLD,50164,12274,5.72
45,Hastinapur,SP,46742,PECP,40101,6641,3.6
46,Kithore,SP,73015,BSP,61909,11106,5.52
47,Meerut Cantt.,BJP,70820,BSP,67207,3613,1.78
48,Meerut,BJP,68154,SP,61876,6278,3.5
49,Meerut South,BJP,71584,BSP,61800,9784,4.48
50,Chhaprauli,RLD,69394,BSP,47823,21571,14.82
51,Baraut,BSP,57209,RLD,51533,5676,3.88
52,Baghpat,BSP,56957,RLD,49294,7663,4.65
53,Loni,BSP,89603,RLD,64355,25248,11.7
54,Muradnagar,BSP,57103,SP,53481,3622,1.68
55,Sahibabad,BSP,124332,BJP,99984,24348,7.3
56,Ghaziabad,BSP,64485,BJP,52364,12121,6.69
57,Modinagar,RLD,58635,BSP,44686,13949,7.87
58,Dholana,SP,59150,BSP,49811,9339,4.62
59,Hapur,INC,77242,BSP,55090,22152,11.99
60,Garhmukteshwar,SP,82816,BSP,64617,18199,9.52
61,Noida,BJP,77319,BSP,49643,27676,13.2
62,Dadri,BSP,81137,BJP,43840,37297,18.7
63,Jewar,BSP,67524,INC,58024,9500,5.32
64,Sikandrabad,BJP,45799,BSP,45676,123,0.06
65,Bulandshahr,BSP,76646,BJP,69699,6947,3.37
66,Siana,INC,53887,BSP,52223,1664,0.8
67,Anupshahr,BSP,51761,SP,48260,3501,1.79
68,Debai,SP,62969,JaKP,59372,3597,1.96
69,Shikarpur,SP,64498,BSP,56095,8403,4.56
70,Khurja,INC,98913,BSP,61609,37304,17.78
71,Khair,RLD,93470,BSP,54696,38774,20.23
72,Barauli,RLD,80440,BSP,68417,12023,5.89
73,Atrauli,SP,54785,JaKP,45918,8867,4.31
74,Chharra,SP,54150,BSP,49364,4786,2.47
75,Koil,SP,44847,INC,44248,599,0.34
76,Aligarh,SP,68291,BJP,45205,23086,12.49
77,Iglas,RLD,66146,BSP,57953,8193,4.3
78,Hathras,BSP,59161,BJP,50488,8673,4.23
79,Sadabad,SP,63741,BSP,58554,5187,2.75
80,Sikandra Rao,BSP,94471,SP,93408,1063,0.52
81,Chhata,RLD,94757,BSP,80163,14594,6.94
82,Mant,AITC,67457,RLD,60853,6604,3.27
83,Goverdhan,BSP,63725,RLD,42230,21495,11.72
84,Mathura,INC,54498,BJP,53997,501,0.25
85,Baldev,RLD,79364,BSP,47270,32094,16.8
86,Etmadpur,BSP,79982,SP,71478,8504,3.6
87,Agra Cantonment,BSP,67786,BJP,61371,6415,3.07
88,Agra South,BJP,74324,BSP,51364,22960,11.67
89,Agra North,BJP,68401,BSP,45045,23356,11.87
90,Agra Rural,BSP,69969,SP,51123,18846,9.39
91,Fatehpur Sikri,BSP,67191,IND,61568,5623,2.77
92,Kheragarh,BSP,69533,SP,62427,7106,3.72
93,Fatehabad,BSP,73098,SP,72399,699,0.38
94,Bah,SP,99379,BSP,72908,26471,14.4
95,Tundla,BSP,67949,SP,60003,7946,3.83
96,Jasrana,SP,104440,BSP,75804,28636,14.07
97,Firozabad,BJP,74878,SP,72863,2015,0.91
98,Shikohabad,SP,98682,BSP,54688,43994,23.17
99,Sirsaganj,SP,85517,BSP,45502,40015,21.53
100,Kasganj,SP,48535,BSP,38356,10179,5.33
101,Amanpur,BSP,37996,SP,34340,3656,2.29
102,Patiyali,SP,62493,BSP,34718,27775,15.75
103,Aliganj,SP,91141,BSP,65120,26021,13.03
104,Etah,SP,39282,BSP,36038,3244,1.98
105,Marhara,SP,61827,JaKP,39571,22256,13.02
106,Jalesar,SP,55391,BSP,32822,22569,15.07
107,Mainpuri,SP,54990,BSP,40781,14209,8.51
108,Bhongaon,SP,70298,BSP,39622,30676,17.8
109,Kishni,SP,77113,BSP,42063,35050,22.84
110,Karhal,SP,92536,BSP,61593,30943,15.68
111,Gunnaur,SP,107378,INC,60720,46658,23.11
112,Bisauli,SP,89457,BSP,46467,42990,21.3
113,Sahaswan,SP,72946,BSP,65919,7027,3.18
114,Bilsi,BSP,57600,SP,49272,8328,4.69
115,Badaun,SP,62786,BJP,47373,15413,7.96
116,Shekhupur,SP,68533,INC,60281,8252,3.94
117,Dataganj,BSP,63626,SP,58299,5327,2.48
118,Baheri,SP,48172,BJP,48154,18,0.01
119,Meerganj,BSP,57446,BJP,49525,7921,4.31
120,Bhojipura,IEMC,65531,SP,47583,17948,8.91
121,Nawabganj,SP,67022,BSP,49303,17719,9.41
122,Faridpur,SP,60837,BJP,44050,16787,9.68
123,Bithari Chainpur,BSP,55972,SP,52557,3415,1.64
124,Bareilly,BJP,68983,SP,41921,27062,14.59
125,Bareilly Cantt.,BJP,51893,SP,32944,18949,12.31
126,Aonla,BJP,50782,SP,46374,4408,2.68
127,Pilibhit,SP,61578,BSP,57343,4235,1.88
128,Barkhera,SP,69256,BJP,38882,30374,15.47
129,Puranpur,SP,73847,BJP,43009,30838,13.77
130,Bisalpur,BJP,111735,INC,55664,56071,24.94
131,Katra,SP,51025,BSP,50150,875,0.47
132,Jalalabad,BSP,76406,SP,75856,550,0.27
133,Tilhar,BSP,71122,SP,60415,10707,5.46
134,Powayan,SP,59871,BSP,50973,8898,4.28
135,Shahjahanpur,BJP,81581,SP,65403,16178,8.92
136,Dadraul,SP,61967,BSP,57088,4879,2.31
137,Palia,BSP,55460,SP,49541,5919,2.91
138,Nighasan,BJP,75005,SP,43966,31039,15.06
139,Gola Gokrannath,SP,82439,BSP,63110,19329,8.68
140,Srinagar,SP,69776,BSP,37898,31878,17.11
141,Dhaurahra,BSP,64139,SP,63094,1045,0.5
142,Lakhimpur,SP,82713,BSP,44720,37993,17.75
143,Kasta,SP,88548,BSP,61677,26871,13.74
144,Mohammadi,BSP,57737,SP,46393,11344,5.67
145,Maholi,SP,87160,BSP,64445,22715,10.43
146,Sitapur,SP,58370,BSP,48072,10298,5.24
147,Hargaon,BSP,73889,SP,61740,12149,6.31
148,Laharpur,BSP,71860,INC,54188,17672,9.12
149,Biswan,SP,74441,BSP,67092,7349,3.77
150,Sevata,SP,49510,INC,47063,2447,1.39
151,Mahmoodabad,SP,86580,BSP,66991,19589,10.54
152,Sidhauli,SP,73714,BSP,67083,6631,3.3
153,Misrikh,SP,61346,BSP,59824,1522,0.81
154,Sawaijpur,BSP,49099,JaKP,44580,4519,2.15
155,Shahabad,SP,89947,BSP,78813,11134,5.48
156,Hardoi,SP,110063,BSP,66381,43682,21.67
157,Gopamau,SP,67430,BSP,61227,6203,3.38
158,Sandi,SP,66325,BSP,59675,6650,3.82
159,Bilgram Mallanwan,BSP,64768,SP,57440,7328,3.45
160,Balamau,SP,67800,BSP,67627,173,0.1
161,Sandila,SP,84644,BSP,65510,19134,9.92
162,Bangarmau,SP,55528,BSP,48733,6795,3.81
163,Safipur,SP,72869,BSP,63815,9054,5.33
164,Mohan,BSP,48021,BJP,38852,9169,4.96
165,Unnao,SP,61695,BJP,51550,10145,5.57
166,Bhagwant Nagar,SP,69514,BJP,45685,23829,11.47
167,Purwa,SP,85073,BSP,57172,27901,13.43
168,Malihabad,SP,62782,RCP,60567,2215,1.1
169,Bakshi Kaa Talab,SP,79629,BSP,77730,1899,0.88
170,Sarojini Nagar,SP,67601,BSP,59236,8365,3.57
171,Lucknow West,SP,49912,BJP,42100,7812,4.59
172,Lucknow North,SP,47580,INC,45361,2219,1.31
173,Lucknow East,BJP,68726,SP,47908,20818,11
174,Lucknow Central,SP,62622,BJP,39890,22732,13.45
175,Lucknow Cantt,INC,63052,BJP,41299,21753,13.44
176,Mohanlalganj,SP,69488,BSP,45971,23517,11.33
177,Bachhrawan,SP,59576,RSBP,31628,27948,15.21
178,Tiloi,INC,61249,SP,58539,2710,1.47
179,Harchandpur,SP,51262,INC,37069,14193,8.61
180,Rae Bareli,PECP,75588,SP,46094,29494,15.5
181,Salon,SP,69020,INC,48443,20577,12.01
182,Sareni,SP,61666,BSP,48747,12919,6.93
183,Unchahar,SP,61930,BSP,59348,2582,1.38
184,Jagdishpur,INC,56309,SP,50912,5397,3.12
185,Gauriganj,SP,44287,INC,43784,503,0.28
186,Amethi,SP,58434,INC,49674,8760,5.37
187,Isauli,SP,48813,PECP,34872,13941,8.17
188,Sultanpur,SP,57811,BSP,50999,6812,3.76
189,Sadar,SP,71939,BSP,51032,20907,12.49
190,Lambhua,SP,74352,BSP,56980,17372,9.64
191,Kadipur,SP,97283,BSP,59173,38110,20.13
192,Kaimganj,SP,56279,BJP,34441,21838,11.17
193,Amritpur,SP,50911,JaKP,31940,18971,11.97
194,Farrukhabad,IND,33005,BJP,32858,147,0.08
195,Bhojpur,SP,51650,JaKP,33021,18629,10.81
196,Chhibramau,SP,70372,BSP,67946,2426,1.08
197,Tirwa,SP,78391,BSP,45899,32492,17.37
198,Kannauj,SP,95702,BSP,50020,45682,22.01
199,Jaswantnagar,SP,133563,BSP,52479,81084,37.58
200,Etawah,SP,74874,BSP,68610,6264,3.13
201,Bharthana,SP,85964,BSP,67999,17965,8.58
202,Bidhuna,SP,72226,BSP,54120,18106,9.05
203,Dibiyapur,SP,76819,BSP,52528,24291,13.71
204,Auraiya,SP,63477,BSP,51415,12062,6.93
205,Rasulabad,SP,66940,BSP,50105,16835,9.92
206,Akbarpur Raniya,SP,69148,BSP,67905,1243,0.67
207,Sikandra,BSP,54482,BJP,52293,2189,1.2
208,Bhognipur,SP,57555,BSP,52902,4653,2.37
209,Bilhaur,SP,87804,BSP,71747,16057,7.47
210,Bithoor,SP,61081,BSP,60410,671,0.33
211,Kalyanpur,SP,44789,BJP,42406,2383,1.59
212,Govind Nagar,BJP,57156,INC,44779,12377,7.65
213,Sishamau,SP,56496,BJP,36833,19663,14.68
214,Arya Nagar,BJP,51200,SP,35789,15411,12.26
215,Kidwai Nagar,INC,63400,BJP,61373,2027,1.15
216,Kanpur Cantt.,BJP,42551,SP,33243,9308,6.45
217,Maharajpur,BJP,83144,BSP,49969,33175,15.16
218,Ghatampur,SP,50669,BSP,49969,700,0.39
219,Madhogarh,BSP,71671,SP,50319,21352,8.5
220,Kalpi,INC,64289,BSP,57639,6650,2.99
221,Orai,SP,67298,BSP,60165,7133,3
222,Babina,BSP,68144,SP,61189,6955,3.49
223,Jhansi Nagar,BJP,67043,BSP,58963,8080,3.78
224,Mauranipur,SP,67785,BSP,61137,6648,2.85
225,Garautha,SP,70041,BSP,54243,15798,7.61
226,Lalitpur,BSP,79797,SP,68474,11323,4.12
227,Mehroni,BSP,70847,BJP,69110,1737,0.64
228,Hamirpur,BJP,63762,BSP,55938,7824,3.39
229,Rath,INC,91295,SP,55158,36137,16.02
230,Mahoba,BSP,43963,SP,43609,354,0.2
231,Charkhari,BJP,66888,SP,41623,25265,13.13
232,Tindwari,INC,61184,SP,46169,15015,9.25
233,Baberu,SP,41642,BSP,40494,1148,0.67
234,Naraini,BSP,52195,SP,47438,4757,2.75
235,Banda,INC,49455,BSP,41853,7602,4.93
236,Chitrakoot,SP,65267,BSP,49131,16136,8.85
237,Manikpur,BSP,43818,SP,40121,3697,2.22
238,Jahanabad,SP,78920,BSP,42709,36211,20.38
239,Bindki,BSP,49090,BJP,41128,7962,4.53
240,Fatehpur,SP,49830,BSP,46044,3786,2.03
241,Ayah Shah,BSP,49339,SP,38242,11097,7.6
242,Husainganj,BSP,44757,INC,41906,2851,1.66
243,Khaga,BJP,59234,BSP,40312,18922,10.76
244,Rampur Khas,INC,74545,BSP,43011,31534,20.9
245,Babaganj,IND,69332,BSP,27266,42066,29.9
246,Kunda,IND,111392,BSP,23137,88255,53.84
247,Bishwavnathganj,SP,49138,BSP,39951,9187,5.06
248,Pratapgarh,SP,43754,BSP,36244,7510,4.45
249,Patti,SP,61434,BJP,61278,156,0.08
250,Raniganj,SP,63076,BSP,50472,12604,7.78
251,Sirathu,BJP,57926,BSP,48063,9863,5.15
252,Manjhanpur,BSP,91000,SP,86818,4182,2.01
253,Chail,BSP,54796,SP,53506,1290,0.72
254,Phaphamau,SP,51950,BSP,46654,5296,2.97
255,Soraon,SP,61153,BSP,47852,13301,7.15
256,Phulpur,SP,72898,BSP,64998,7900,4.2
257,Pratappur,SP,62582,BSP,49774,12808,7
258,Handia,SP,81655,BSP,54838,26817,14.7
259,Meja,SP,44823,BSP,44083,740,0.47
260,Karachhana,BSP,68341,SP,67937,404,0.23
261,Allahabad West,BSP,71114,AD,62229,8885,5.01
262,Allahabad North,INC,54787,BSP,38695,16092,11.09
263,Allahabad South,SP,43040,BSP,42626,414,0.28
264,Bara,SP,46182,BSP,42426,3756,2.18
265,Koraon,BSP,44755,CPM,36982,7773,4.31
266,Kursi,SP,80183,BSP,56246,23937,10.2
267,Ramnagar,SP,77428,BSP,45204,32224,15.97
268,Barabanki,SP,82343,BSP,59573,22770,10.7
269,Zaidpur,SP,76869,BSP,53828,23041,10.13
270,Dariyabad,SP,84147,BSP,64253,19894,8.44
271,Rudauli,BJP,61173,SP,60232,941,0.5
272,Haidergarh,SP,60232,BSP,51792,8440,4.48
273,Milkipur,SP,73803,BSP,39566,34237,19.6
274,Bikapur,SP,55232,BSP,53364,1868,0.93
275,Ayodhya,SP,55262,BJP,49857,5405,2.81
276,Goshainganj,SP,122235,BSP,63554,58681,28.06
277,Katehari,SP,94641,BSP,77021,17620,8.72
278,Tanda,SP,83249,BSP,55728,27521,15.64
279,Alapur,SP,79846,BSP,49823,30023,18.1
280,Jalalpur,SP,89267,BSP,72003,17264,8.11
281,Akbarpur,SP,91126,BSP,64840,26286,14.8
282,Balha,BJP,58823,BSP,38895,19928,11.25
283,Nanpara,INC,46987,BSP,42665,4322,2.62
284,Matera,SP,41944,INC,39143,2801,1.75
285,Mahasi,BSP,40546,BJP,38057,2489,1.54
286,Bahraich,SP,50759,INC,35263,15496,9.01
287,Payagpur,INC,65176,BSP,38130,27046,14.45
288,Kaiserganj,BJP,45262,SP,38294,6968,3.73
289,Bhinga,SP,65365,INC,58538,6827,3.31
290,Shrawasti,SP,67551,BSP,56346,11205,5.69
291,Tulsipur,SP,67105,BSP,33395,33710,19.77
292,Gainsari,SP,56744,BSP,33044,23700,14.1
293,Utraula,SP,40447,BSP,39442,1005,0.6
294,Balrampur,SP,47120,BJP,28858,18262,11.23
295,Mehnaun,SP,71667,BSP,38623,33044,18.46
296,Gonda,SP,62058,BJP,47203,14855,8.91
297,Katra Bazar,BJP,65355,BSP,58408,6947,3.54
298,Colonelganj,SP,67723,BSP,56002,11721,7.51
299,Tarabganj,SP,52395,BSP,47215,5180,2.78
300,Mankapur,SP,78311,BSP,51141,27170,17.41
301,Gaura,SP,42773,INC,35678,7095,4.33
302,Shohratgarh,SP,50935,BSP,33423,17512,10.66
303,Kapilvastu,SP,78344,BJP,41474,36870,19.39
304,Bansi,BJP,47323,SP,44429,2894,1.72
305,Itwa,SP,46142,BSP,34408,11734,7.97
306,Domariaganj,PECP,44428,BSP,42839,1589,0.9
307,Harraiya,SP,84409,BSP,64123,20286,10.41
308,Kaptanganj,BSP,67416,SP,56346,11070,5.92
309,Rudhauli,INC,55950,BSP,50107,5843,2.88
310,Basti Sadar,BSP,53011,INC,34008,19003,10.48
311,Mahadewa,SP,83202,BSP,63943,19259,10.61
312,Menhdawal,SP,56107,PECP,40030,16077,7.75
313,Khalilabad,PECP,55841,BSP,50449,5392,2.61
314,Dhanghata,SP,66337,BSP,51388,14949,8.01
315,Pharenda,BJP,47921,INC,34586,13335,7.31
316,Nautanwa,INC,76584,SP,68747,7837,4.15
317,Siswa,SP,54591,BJP,37749,16842,7.75
318,Maharajganj,SP,84581,BSP,48426,36155,16.72
319,Paniyara,BSP,56114,BJP,52031,4083,1.93
320,Caimpiyarganj,NCP,71906,SP,62948,8958,4.56
321,Pipraich,SP,86976,BSP,51341,35635,17.82
322,Gorakhpur Urban,BJP,81148,SP,33694,47454,28.76
323,Gorakhpur Rural,BJP,58849,SP,41864,16985,9.04
324,Sahajanwa,BSP,52949,BJP,40258,12691,7.05
325,Khajani,BJP,57920,BSP,48484,9436,5.72
326,Chauri Chaura,BSP,49687,SP,29086,20601,12.14
327,Bansgaon,BSP,53690,SP,45344,8346,5.54
328,Chillupar,BSP,61639,SP,50486,11153,5.57
329,Khadda,INC,37260,SP,35115,2145,1.26
330,Padrauna,BSP,42184,INC,34022,8162,4.34
331,Tamkuhi Raj,INC,53121,BJP,47261,5860,2.98
332,Fazilnagar,BJP,49995,BSP,44501,5494,2.94
333,Kushinagar,SP,66489,BSP,42801,23688,13.23
334,Hata,SP,55591,BSP,38923,16668,9
335,Ramkola,SP,50861,BJP,32295,18566,11.02
336,Rudrapur,INC,40783,SP,33356,7427,4.8
337,Deoria,BJP,56299,BSP,33004,23295,14.02
338,Pathardeva,SP,59905,BJP,55351,4554,2.51
339,Rampur Karkhana,SP,51834,IND,44687,7147,4.02
340,Bhatpar Rani,SP,73100,SBSP,38998,34102,21.65
341,Salempur,SP,47884,BJP,31726,16158,11.4
342,Barhaj,SP,65672,BSP,53896,11776,7.61
343,Atraulia,SP,97486,BSP,53866,43620,23.4
344,Gopalpur,SP,77697,BSP,47563,30134,18.48
345,Sagri,SP,56114,BSP,46863,9251,5.93
346,Mubarakpur,BSP,50128,SP,41562,8566,5
347,Azamgarh,SP,93629,BSP,62188,31441,16.93
348,Nizamabad,SP,63894,BSP,40051,23843,15.76
349,Phoolpur Pawai,SP,47172,BSP,46307,865,0.53
350,Didarganj,SP,64361,BSP,62134,2227,1.27
351,Lalganj,SP,64746,BSP,53734,11012,6.17
352,Mehnagar,SP,60341,BSP,49979,10362,5.77
353,Madhuban,BSP,51572,SP,50216,1356,0.73
354,Ghosi,SP,73688,BSP,58144,15544,7.49
355,Muhammadabad Gohna,SP,52691,BSP,49552,3139,1.72
356,Mau,QED,70210,BSP,64306,5904,2.63
357,Belthara Road,SP,57363,BSP,47066,10297,6.02
358,Rasara,BSP,84436,SP,31611,52825,29.29
359,Sikanderpur,SP,58266,BSP,29735,28531,17.98
360,Phephana,BJP,51151,SP,43764,7387,4.35
361,Ballia Nagar,SP,58875,QED,33747,25128,14.83
362,Bansdih,SP,52085,BJP,29208,22877,11.83
363,Bairia,SP,46092,BJP,45534,558,0.39
364,Badlapur,SP,65278,BSP,49085,16193,9.19
365,Shahganj,SP,74486,BSP,64263,10223,5.23
366,Jaunpur,INC,50863,BSP,49624,1239,0.62
367,Malhani,SP,81602,IND,50100,31502,16.28
368,Mungra Badshahpur,BJP,50065,BSP,44004,6061,3.25
369,Machhlishahr,SP,82484,BSP,58059,24425,13.05
370,Mariyahu,SP,55745,BSP,43268,12477,7.52
371,Zafrabad,SP,59419,BSP,54002,5417,2.8
372,Kerakat,SP,67470,BSP,57284,10186,4.88
373,Jakhanian,SP,72561,BSP,57331,15230,7.52
374,Saidpur,SP,90624,BSP,48655,41969,22.5
375,Ghazipur,SP,49561,BSP,49320,241,0.13
376,Jangipur,SP,72208,BSP,62744,9464,5.09
377,Zahoorabad,SP,67012,BSP,56534,10478,5.16
378,Mohammadabad,QED,66922,SP,59589,7333,3.58
379,Zamania,SP,83407,BSP,53967,29440,14.65
380,Mughalsarai,BSP,59083,SP,43643,15440,8.24
381,Sakaldiha,IND,66509,SP,59661,6848,3.71
382,Saiyadraja,IND,51499,PMSP,49483,2016,1.14
383,Chakia,SP,91285,BSP,82603,8682,4.16
384,Pindra,INC,52863,BSP,43645,9218,5.11
385,Ajagara,BSP,60239,SP,58156,2083,1.12
386,Shivpur,BSP,48716,SP,36084,12632,6.86
387,Rohaniya,AD,57812,BSP,40229,17583,9.19
388,Varanasi North,BJP,47980,BSP,45644,2336,1.29
389,Varanasi South,BJP,57868,INC,44046,13822,9.13
390,Varanasi Cantt.,BJP,57918,INC,45066,12852,7.11
391,Sevapuri,SP,56849,AD,36942,19907,11.16
392,Bhadohi,SP,78698,BSP,62457,16241,7.78
393,Gyanpur,SP,91604,BSP,53930,37674,21.25
394,Aurai,SP,83827,BSP,61954,21873,12.34
395,Chhanbey,SP,57488,BSP,47194,10294,5.55
396,Mirzapur,SP,69099,BSP,46800,22299,11.78
397,Majhawan,BSP,83870,SP,74141,9729,4.61
398,Chunar,SP,67265,BSP,46557,20708,11.19
399,Marihan,INC,63492,SP,54969,8523,3.98
400,Ghorawal,SP,87708,BSP,72521,15187,7.44
401,Robertsganj,SP,47139,BSP,41798,5341,3.24
402,Obra,BSP,31513,BJP,24453,7060,4.91
403,Duddhi,IND,42028,SP,35989,6039,3.79