const_code,constituency,win_party,win_votes,second_party,second_votes,None of the Above,margin,percent
1,Behat,INC,97035,BJP,71449,1576,25586,10.13
2,Nakur,BJP,94375,INC,90318,1232,4057,1.59
3,Saharanpur Nagar,SP,127210,BJP,122574,675,4636,1.7
4,Saharanpur,INC,87689,BSP,75365,968,12324,5.19
5,Deoband,BJP,102244,BSP,72844,798,29400,12.55
6,Rampur Maniharan,BJP,76465,BSP,75870,856,595,0.27
7,Gangoh,BJP,99446,INC,61418,971,38028,14.78
8,Kairana,SP,98830,BJP,77668,1060,21162,10.12
9,Thana Bhawan,BJP,90995,BSP,74178,883,16817,7.91
10,Shamli,BJP,70085,INC,40365,901,29720,15.14
11,Budhana,BJP,97781,SP,84580,1286,13201,5.47
12,Charthawal,BJP,82046,SP,58815,1018,23231,11.22
13,Purqazi,BJP,77491,INC,66238,1139,11253,5.51
14,Muzaffar Nagar,BJP,97838,SP,87134,1133,10704,4.96
15,Khatauli,BJP,94771,SP,63397,694,31374,14.72
16,Meerapur,BJP,69035,SP,68842,1090,193,0.09
17,Najibabad,SP,81082,BJP,79080,1516,2002,0.93
18,Nagina,SP,77145,BJP,69178,1431,7967,3.8
19,Barhapur,BJP,78744,INC,68920,556,9824,4.42
20,Dhampur,BJP,82169,SP,64305,1020,17864,9.26
21,Nehtaur,BJP,76644,INC,53493,1273,23151,12.3
22,Bijnor,BJP,105548,SP,78267,1241,27281,11.1
23,Chandpur,BJP,92345,BSP,56696,932,35649,16.32
24,Noorpur,BJP,79172,SP,66436,1115,12736,6.27
25,Kanth,BJP,76307,SP,73959,1199,2348,0.93
26,Thakurdwara,SP,107865,BJP,94456,1040,13409,5.23
27,Moradabad Rural,SP,97916,BJP,69135,639,28781,13
28,Moradabad Nagar,BJP,123467,SP,120274,855,3193,1.15
29,Kundarki,SP,110561,BJP,99740,1170,10821,4.09
30,Bilari,SP,85682,BJP,72241,1123,13441,5.87
31,Chandausi,BJP,104806,INC,59337,2135,45469,20.29
32,Asmoli,SP,97610,BJP,76484,1872,21126,8.45
33,Sambhal,SP,79248,All India Majlis-E-Ittehadul Muslimeen,60426,1683,18822,7.77
34,Suar,SP,106443,BJP,53347,872,53096,25.78
35,Chamraua,SP,87400,BSP,53024,1077,34376,17.69
36,Bilaspur,BJP,99100,INC,76741,1227,22359,10
37,Rampur,SP,102100,BJP,55258,1191,46842,21.78
38,Milak,BJP,89861,SP,73194,1477,16667,7.7
39,Dhanaura,BJP,102943,SP,64714,1824,38229,16.98
40,Naugawan Sadat,BJP,97030,SP,76382,1132,20648,8.82
41,Amroha,SP,74713,BSP,59671,1219,15042,7.47
42,Hasanpur,BJP,111269,SP,83499,1694,27770,10.89
43,Siwalkhas,BJP,72842,SP,61421,1086,11421,5.07
44,Sardhana,BJP,97921,SP,76296,1087,21625,9.04
45,Hastinapur,BJP,99436,BSP,63374,1013,36062,16.29
46,Kithore,BJP,90622,SP,79800,1224,10822,4.46
47,Meerut Cantt.,BJP,132518,BSP,55899,1110,76619,32.34
48,Meerut,SP,103217,BJP,74448,738,28769,14.71
49,Meerut South,BJP,113225,BSP,77830,1401,35395,13.07
50,Chhaprauli,Rashtriya Lok Dal,65124,BJP,61282,1027,3842,1.92
51,Baraut,BJP,79427,Rashtriya Lok Dal,52941,870,26486,14.3
52,Baghpat,BJP,92566,BSP,61206,954,31360,15.79
53,Loni,BJP,113088,BSP,70275,1663,42813,15.59
54,Muradnagar,BJP,140759,BSP,51147,1053,89612,35.35
55,Sahibabad,BJP,262741,INC,112056,3057,150685,35.38
56,Ghaziabad,BJP,124201,BSP,53696,1184,70505,31.22
57,Modi Nagar,BJP,108631,BSP,42049,1074,66582,30.84
58,Dholana,BSP,88580,BJP,85004,1279,3576,1.41
59,Hapur,BJP,84532,INC,69526,944,15006,6.74
60,Garhmukteshwar,BJP,91086,BSP,55792,572,35294,15.92
61,Noida,BJP,162417,SP,58401,1787,104016,40.89
62,Dadri,BJP,141226,BSP,61049,1665,80177,30.22
63,Jewar,BJP,102979,BSP,80806,1276,22173,10.49
64,Sikandrabad,BJP,104956,BSP,76333,1038,28623,11.36
65,Bulandshahr,BJP,111538,BSP,88454,1638,23084,9.42
66,Syana,BJP,125854,BSP,54224,1392,71630,30.82
67,Anupshahr,BJP,112431,BSP,52117,1620,60314,26.25
68,Debai,BJP,111807,SP,46177,2048,65630,31.28
69,Shikarpur,BJP,101912,BSP,51667,2115,50245,24.78
70,Khurja,BJP,119493,BSP,55194,1716,64299,27.13
71,Khair,BJP,124198,BSP,53477,1651,70721,30.47
72,Barauli,BJP,125545,BSP,86782,1338,38763,16.49
73,Atrauli,BJP,115397,SP,64430,1325,50967,21.91
74,Chharra,BJP,110738,SP,54604,1250,56134,24.51
75,Koil,BJP,93814,SP,42851,1580,50963,22.29
76,Aligarh,BJP,113752,SP,98312,1375,15440,6.27
77,Iglas,BJP,128000,BSP,53200,1122,74800,32.02
78,Hathras,BJP,133840,BSP,63179,1256,70661,29.62
79,Sadabad,BSP,91385,Rashtriya Lok Dal,64775,1103,26610,11.74
80,Sikandra Rao,BJP,76129,BSP,61357,1426,14772,6.83
81,Chhata,BJP,117537,IND,53699,1224,63838,28.08
82,Mant,BSP,65862,Rashtriya Lok Dal,65430,1253,432,0.21
83,Goverdhan,BJP,93538,BSP,60529,1398,33009,15.94
84,Mathura,BJP,143361,INC,42200,1235,101161,39.97
85,Baldev,BJP,88411,Rashtriya Lok Dal,75203,1601,13208,5.7
86,Etmadpur,BJP,137381,BSP,90126,1872,47255,16.63
87,Agra Cantt.,BJP,113178,BSP,66853,1185,46325,18.32
88,Agra South,BJP,111882,BSP,57657,753,54225,24.96
89,Agra North,BJP,135120,BSP,48800,1266,86320,37.41
90,Agra Rural,BJP,129887,BSP,64591,1856,65296,26.13
91,Fatehpur Sikri,BJP,108586,BSP,56249,1864,52337,22.82
92,Kheragarh,BJP,93510,BSP,61511,1223,31999,16.1
93,Fatehabad,BJP,101960,SP,67596,1470,34364,16.38
94,Bah,BJP,80567,BSP,57427,2214,23140,12
95,Tundla,BJP,118584,BSP,62514,1381,56070,23.02
96,Jasrana,BJP,103426,SP,83098,1908,20328,8.82
97,Firozabad,BJP,102654,SP,60927,906,41727,17.96
98,Shikohabad,BJP,87851,SP,77074,1700,10777,5.02
99,Sirsaganj,SP,90281,BJP,79605,1552,10676,5.26
100,Kasganj,BJP,101908,SP,49878,2023,52030,23.64
101,Amanpur,BJP,85199,SP,43395,1242,41804,22.75
102,Patiyali,BJP,72414,SP,68643,1556,3771,1.86
103,Aliganj,BJP,88695,SP,74844,1572,13851,6.39
104,Etah,BJP,82516,SP,61387,1277,21129,10.48
105,Marhara,BJP,92507,SP,59075,1351,33432,17.47
106,Jalesar,BJP,81502,SP,61694,1188,19808,10.73
107,Mainpuri,SP,75787,BJP,66956,1157,8831,4.49
108,Bhongaon,BJP,92697,SP,72400,1242,20297,10.37
109,Kishani (SC),SP,80475,BJP,63946,1070,16529,9.21
110,Karhal,SP,104221,BJP,65816,1014,38405,18.26
111,Gunnaur,BJP,107344,SP,95958,2639,11386,5
112,Bisauli,BJP,100287,SP,89599,2342,10688,4.67
113,Sahaswan,SP,77543,BSP,73274,2902,4269,1.77
114,Bilsi,BJP,82070,BSP,55091,1930,26979,13.76
115,Badaun,BJP,87314,SP,70847,1509,16467,7.74
116,Shekhupur,BJP,93702,SP,70316,1896,23386,9.91
117,Dataganj,BJP,79110,BSP,53351,1971,25759,11.46
118,Baheri,BJP,108846,BSP,66009,1479,42837,17.29
119,Meerganj,BJP,108789,BSP,54289,1749,54500,25.92
120,Bhojipura,BJP,100381,SP,72617,1763,27764,11.63
121,Nawabganj,BJP,93711,SP,54569,1860,39142,18.18
122,Faridpur,BJP,83656,SP,58935,1831,24721,13
123,Bithari Chainpur,BJP,96397,SP,76886,2647,19511,8.3
124,Bareilly,BJP,115010,INC,86343,1421,28667,12.81
125,Bareilly Cantt.,BJP,88441,INC,75777,1061,12664,6.9
126,Aonla,BJP,63165,SP,59619,1794,3546,1.95
127,Pilibhit,BJP,136486,SP,93130,1818,43356,17.22
128,Barkhera,BJP,104595,SP,46665,2307,57930,27.34
129,Puranpur,BJP,128493,SP,89251,2246,39242,15.9
130,Bisalpur,BJP,103498,INC,62502,2301,40996,18.39
131,Katra,BJP,76509,SP,59779,1830,16730,8.67
132,Jalalabad,SP,75326,BJP,66029,1614,9297,4.46
133,Tilhar,BJP,81770,INC,76065,1683,5705,2.79
134,Powayan,BJP,126635,SP,54218,2065,72417,31.59
135,Shahjahanpur,BJP,100734,SP,81531,1151,19203,9.32
136,Dadraul,BJP,86435,SP,69037,2383,17398,8.03
137,PALIA,BJP,118069,INC,48841,2077,69228,29.87
138,NIGHASAN,BJP,107487,SP,61364,2663,46123,20.76
139,GOLA GOKRANNATH,BJP,122497,SP,67480,3022,55017,21.93
140,SRI NAGAR,BJP,112941,SP,58002,2141,54939,24.65
141,DHAURAHRA,BJP,79809,SP,76456,3360,3353,1.51
142,LAKHIMPUR,BJP,122677,SP,84929,2434,37748,14.77
143,KASTA,BJP,92824,SP,68551,1978,24273,11.56
144,MOHAMMDI,BJP,93000,INC,59082,2330,33918,15.48
145,Maholi,BJP,80938,SP,77221,1665,3717,1.54
146,Sitapur,BJP,98850,SP,74011,1842,24839,10.61
147,Hargaon,BJP,101680,BSP,56685,2220,44995,20.34
148,Laharpur,BJP,79467,BSP,70349,2861,9118,3.97
149,Biswan,BJP,81907,SP,71672,2080,10235,4.49
150,Sevata,BJP,94697,BSP,51038,2990,43659,20.39
151,Mahmoodabad,SP,81469,BJP,79563,1898,1906,0.9
152,Sidhauli,BSP,78506,SP,75996,2169,2510,1.08
153,Misrikh,BJP,86403,BSP,65731,2222,20672,9.41
154,Sawaijpur,BJP,92601,SP,65631,1831,26970,11.63
155,Shahabad,BJP,99624,BSP,95364,2615,4260,1.94
156,Hardoi,SP,97735,BJP,92626,2203,5109,2.22
157,Gopamau,BJP,87871,SP,56493,2252,31378,15.45
158,Sandi,BJP,72044,INC,51819,2222,20225,10.89
159,Bilgram-Mallanwan,BJP,83405,SP,75380,1826,8025,3.62
160,Balamau,BJP,74917,BSP,52029,2005,22888,12.17
161,Sandila,BJP,90362,SP,69959,1532,20403,10.27
162,Bangermau,BJP,87657,SP,59330,1873,28327,14.02
163,Safipur,BJP,84068,BSP,56832,1820,27236,13.81
164,Mohan,BJP,104884,BSP,50789,2235,54095,26.71
165,Unnao,BJP,119669,SP,73597,1843,46072,19.91
166,Bhagwantnagar,BJP,103698,BSP,50332,2730,53366,22.77
167,Purwa,BSP,97567,BJP,71084,2719,26483,10.81
168,Malihabad,BJP,94677,SP,72009,1692,22668,9.95
169,Bakshi Kaa Talab,BJP,96482,BSP,78898,2271,17584,6.64
170,Sarojini Nagar,BJP,108506,SP,74327,1926,34179,11.75
171,Lucknow West,BJP,93022,SP,79950,635,13072,6.01
172,Lucknow North,BJP,109315,SP,82039,1370,27276,12.05
173,Lucknow East,BJP,135167,INC,55937,1747,79230,34.73
174,Lucknow Central,BJP,78400,SP,73306,824,5094,2.61
175,175-LUCKNOW CANTT.,BJP,95402,SP,61606,1150,33796,18.03
176,Mohanlalganj,SP,71574,BSP,71044,3471,530,0.24
177,Bachhrawan,BJP,65324,INC,43015,3325,22309,11.26
178,Tiloi,BJP,96119,BSP,52072,2567,44047,22.5
179,Harchandpur,INC,65104,BJP,61452,2376,3652,1.97
180,Rae Bareli,INC,128319,BSP,39156,3448,89163,43.01
181,Salon,BJP,78028,INC,61973,3540,16055,8.32
182,Sareni,BJP,65873,BSP,52866,2545,13007,6.35
183,Unchahar,SP,59103,BJP,57169,2517,1934,0.93
184,Jagdishpur,BJP,84219,INC,67619,3104,16600,8.6
185,Gauriganj,SP,77915,INC,51496,1155,26419,13.14
186,Amethi,BJP,64226,SP,59161,694,5065,2.7
187,Isauli,SP,51583,BJP,47342,2256,4241,2.21
188,Sultanpur,BJP,86786,BSP,54393,1234,32393,15.81
189,Sadar,BJP,68950,BSP,50177,1935,18773,9.92
190,Lambhua,BJP,78627,BSP,65724,1785,12903,6.4
191,Kadipur,BJP,87353,BSP,60749,2718,26604,12.64
192,Kaimganj,BJP,116304,SP,79779,1964,36525,15.63
193,Amritpur,BJP,93502,SP,52995,1250,40507,23.19
194,Farrukhabad,BJP,93626,BSP,48199,359,45427,21.84
195,Bhojpur,BJP,93673,SP,58796,299,34877,18.58
196,Chhibramau,BJP,112209,BSP,74985,1861,37224,13.85
197,Tirwa,BJP,100426,SP,76217,1872,24209,11.26
198,Kannauj,SP,99635,BJP,97181,1706,2454,0.99
199,Jaswantnagar,SP,126834,BJP,74218,1327,52616,22.58
200,Etawah,BJP,91234,SP,73892,594,17342,7.85
201,Bharthana,BJP,82005,SP,80037,1608,1968,0.86
202,Bidhuna,BJP,81905,SP,77995,1270,3910,1.79
203,Dibiyapur,BJP,71480,SP,59386,690,12094,6.31
204,Auraiya,BJP,83580,BSP,51718,1191,31862,17.24
205,Rasulabad,BJP,88390,SP,54996,1421,33394,17.63
206,Akbarpur - Raniya,BJP,87430,SP,58701,1098,28729,14.14
207,Sikandra,BJP,87879,BSP,49776,1442,38103,19.67
208,Bhognipur,BJP,71466,BSP,52461,1565,19005,8.94
209,Bilhaur,BJP,102326,BSP,71160,1965,31166,12.95
210,Bithoor,BJP,113289,SP,54302,1900,58987,25.59
211,Kalyanpur,BJP,86620,SP,63278,921,23342,13.12
212,Govindnagar,BJP,112029,INC,40520,1247,71509,38.6
213,Sishamau,SP,73030,BJP,67204,791,5826,3.78
214,Arya Nagar,SP,70993,BJP,65270,681,5723,3.88
215,KIDWAI NAGAR,BJP,111407,INC,77424,1117,33983,16.57
216,Kanpur Cantt.,INC,81169,BJP,71805,729,9364,5.31
217,Maharajpur,BJP,132394,BSP,40568,1359,91826,38.79
218,Ghatampur,BJP,92776,BSP,47598,2160,45178,23.63
219,Madhaugarh,BJP,108737,BSP,62752,2582,45985,18.2
220,Kalpi,BJP,105988,BSP,54504,2356,51484,22.45
221,Orai,BJP,140485,SP,61606,2169,78879,29.75
222,Babina,BJP,96713,SP,79876,1982,16837,7.32
223,Jhansi Nagar,BJP,117873,BSP,62095,953,55778,23.03
224,Mauranipur,BJP,98905,SP,81934,3536,16971,6.31
225,Garautha,BJP,93378,SP,77547,2645,15831,6.92
226,Lalitpur,BJP,156942,SP,88687,4859,68255,21.47
227,Mehroni,BJP,159291,BSP,59727,4092,99564,32.35
228,Hamirpur,BJP,110888,SP,62233,3356,48655,19.26
229,Rath,BJP,147526,INC,42883,4595,104643,43.24
230,Mahoba,BJP,88291,SP,56904,2720,31387,15.91
231,Charkhari,BJP,98360,SP,54346,2775,44014,20.6
232,Tindwari,BJP,82197,BSP,44790,2875,37407,20.24
233,Baberu,BJP,76187,BSP,53886,3559,22301,11.5
234,Naraini,BJP,92412,INC,47405,3655,45007,22.06
235,Banda,BJP,83169,BSP,50341,979,32828,18
236,Chitrakoot,BJP,90366,SP,63430,3529,26936,12.18
237,Manikpur,BJP,84988,INC,40524,3752,44464,22.85
238,Jahanabad,Apna Dal (Soneylal),81438,SP,33832,1262,47606,26.23
239,Bindki,BJP,97996,SP,41618,2142,56378,30.65
240,Fatehpur,BJP,89481,SP,57983,1961,31498,16.14
241,Ayah Shah,BJP,81203,SP,29238,1600,51965,34.43
242,Husainganj,BJP,73595,INC,55002,2361,18593,10.58
243,Khaga,BJP,94954,INC,38520,3801,56434,30.58
244,Rampur Khas,INC,81463,BJP,64397,1595,17066,10
245,Babaganj,IND,87778,BJP,50618,3386,37160,22.12
246,Kunda,IND,136597,BJP,32950,3992,103647,51.56
247,Vishwanathganj,Apna Dal (Soneylal),81899,INC,58541,1951,23358,11.88
248,Pratapgarh,Apna Dal (Soneylal),80828,SP,46274,2191,34554,18.66
249,Patti,BJP,75011,SP,73538,2244,1473,0.71
250,Raniganj,BJP,67031,BSP,58022,1259,9009,5.08
251,Sirathu,BJP,78621,SP,52418,1806,26203,13.36
252,Manjhanpur,BJP,92818,BSP,88658,3949,4160,1.86
253,Chail,BJP,85713,INC,45597,1352,40116,19.73
254,Phaphamau,BJP,83239,SP,57254,2571,25985,12.66
255,Soraon,Apna Dal (Soneylal),77814,BSP,60079,2460,17735,8.34
256,Phulpur,BJP,93912,SP,67299,1614,26613,11.88
257,Pratappur,BSP,66805,Apna Dal (Soneylal),64151,2916,2654,1.28
258,Handia,BSP,72446,Apna Dal (Soneylal),63920,2414,8526,4.22
259,Meja,BJP,67807,SP,47964,2459,19843,10.95
260,Karachhana,SP,80806,BJP,65782,2308,15024,7.56
261,Allahabad West,BJP,85518,SP,60182,1659,25336,12.75
262,Allahabad North,BJP,89191,INC,54166,659,35025,20.22
263,Allahabad South,BJP,93011,SP,64424,665,28587,16.15
264,Bara,BJP,79209,SP,45156,2327,34053,17.93
265,Koraon,BJP,100427,INC,46731,3208,53696,27.36
266,Kursi,BJP,108403,SP,79724,1460,28679,10.92
267,Ram Nagar,BJP,88937,SP,66210,2094,22727,10.19
268,Barabanki,SP,99453,BSP,69748,1622,29705,12.11
269,Zaidpur,BJP,111064,INC,81883,2968,29181,11.39
270,Dariyabad,BJP,119173,SP,68487,3013,50686,19.91
271,Rudauli,BJP,90311,SP,59052,2225,31259,14.87
272,Haidergarh,BJP,97497,SP,63977,4096,33520,15.65
273,Milkipur,BJP,86960,SP,58684,2727,28276,14.15
274,Bikapur,BJP,94074,SP,67422,2257,26652,11.96
275,Ayodhya,BJP,107014,SP,56574,1544,50440,23.19
276,Goshainganj,BJP,89586,SP,77966,2878,11620,5.11
277,Katehari,BSP,84358,BJP,78071,2235,6287,2.68
278,Tanda,BJP,74768,SP,73043,1530,1725,0.84
279,Alapur,BJP,72366,SP,59853,1949,12513,6.33
280,Jalalpur,BSP,90309,BJP,77279,1531,13030,5.41
281,Akbarpur,BSP,72325,SP,58312,1719,14013,6.86
282,BALHA (S.C.),BJP,104135,BSP,57519,3382,46616,23.04
283,Nanpara,BJP,86312,INC,67643,3121,18669,9.67
284,Matera,SP,79188,BJP,77593,2717,1595,0.79
285,Mahasi,BJP,104654,INC,45685,3201,58969,29.91
286,Bahraich,BJP,87479,SP,80777,2604,6702,3.14
287,Payagpur,BJP,102254,SP,60713,2871,41541,20.15
288,Kaiserganj,BJP,85212,BSP,57849,3291,27363,13.06
289,Bhinga,BSP,76040,BJP,69950,4746,6090,2.7
290,Shrawasti,BJP,79437,SP,78992,4289,445,0.18
291,Tulsipur,BJP,62296,INC,43637,2459,18659,9.45
292,Gainsari,BJP,55716,BSP,53413,1914,2303,1.17
293,Utraula,BJP,85240,SP,56066,1977,29174,14.7
294,Balrampur,BJP,89401,INC,64541,3414,24860,12.86
295,Mehnaun,BJP,84304,BSP,47926,2019,36378,17.58
296,Gonda,BJP,58254,BSP,46576,1594,11678,6.03
297,Katra Bazar,BJP,92095,SP,61284,3014,30811,13.91
298,Colonelganj,BJP,82867,SP,54462,2748,28405,15.57
299,Tarabganj,BJP,100294,SP,61852,3384,38442,18.91
300,Mankapur,BJP,102862,BSP,42701,2769,60161,33.51
301,Gaura,BJP,72455,SP,42600,1435,29855,17.22
302,Shohratgarh,Apna Dal (Soneylal),67653,BSP,45529,1525,22124,11.85
303,Kapilvastu,BJP,114082,SP,75928,2623,38154,16.23
304,Bansi,BJP,77548,SP,58606,1641,18942,10.27
305,Itwa,BJP,59524,BSP,49316,1747,10208,6.34
306,Doomariyaganj,BJP,67227,BSP,67056,1611,171,0.08
307,Harraiya,BJP,97014,SP,66908,2274,30106,14.03
308,Kaptanganj,BJP,70527,BSP,63700,1898,6827,3.39
309,Rudhauli,BJP,90228,BSP,68423,2221,21805,9.8
310,Basti Sadar,BJP,92697,SP,50103,1206,42594,20.61
311,Mahadewa S.C,BJP,82429,BSP,56545,2231,25884,12.99
312,MENHDAWAL,BJP,86976,BSP,44062,2663,42914,19.09
313,KHALILABAD,BJP,72061,BSP,56024,835,16037,7.16
314,Dhanghata,BJP,79572,SP,62663,1871,16909,8.44
315,Pharenda,BJP,76312,INC,73958,1992,2354,1.18
316,Nautanwa,IND,79666,SP,47410,3490,32256,15.01
317,Siswa,BJP,122884,SP,54698,2501,68186,28.49
318,Maharajganj,BJP,125154,BSP,56793,2573,68361,27.65
319,Paniyara,BJP,119308,BSP,51817,2124,67491,27.67
320,Caimpiyarganj,BJP,91636,INC,58782,1806,32854,15.16
321,Pipraich,BJP,82739,BSP,69930,1204,12809,5.21
322,Gorakhpur Urban,BJP,122221,INC,61491,839,60730,27.75
323,Gorakhpur Rural,BJP,83686,SP,79276,1634,4410,1.87
324,Sahajanwa,BJP,72213,SP,56836,1723,15377,7.34
325,Khajani,BJP,71492,BSP,51413,2085,20079,10.69
326,Chauri-Chaura,BJP,87863,SP,42203,1150,45660,23.57
327,Bansgaon,BJP,71966,BSP,49093,2143,22873,12.79
328,Chillupar,BSP,78177,BJP,74818,2512,3359,1.52
329,Khadda,BJP,82537,BSP,44040,2140,38497,19.71
330,Padrauna,BJP,93649,BSP,53097,1658,40552,19.24
331,Tamkuhi Raj,INC,61211,BJP,43097,3305,18114,8.41
332,Fazilnagar,BJP,102778,SP,60856,2811,41922,19.55
333,Kushinagar,BJP,97132,BSP,49029,2208,48103,23.63
334,Hata,BJP,103864,SP,50788,1933,53076,25.49
335,Ramkola,Suheldev Bhartiya Samaj Party,102782,SP,47053,3144,55729,28.25
336,Rudrapur,BJP,77754,INC,50965,2561,26789,16.3
337,Deoria,BJP,88030,SP,41794,1440,46236,25.23
338,Pathardeva,BJP,99812,SP,56815,1450,42997,22.44
339,Rampur Karkhana,BJP,62886,SP,52899,2032,9987,5.19
340,Bhatpar Rani,SP,61862,BJP,50765,2039,11097,6.12
341,Salempur,BJP,76175,SP,50521,1951,25654,15.79
342,Barhaj,BJP,61996,BSP,50280,1338,11716,6.95
343,Atrauliya,SP,74276,BJP,71809,1980,2467,1.17
344,Gopalpur,SP,70980,BJP,56020,1521,14960,7.9
345,Sagri,BSP,62203,SP,56728,964,5475,3.06
346,Mubarakpur,BSP,70705,SP,70017,1628,688,0.36
347,Azamgarh,SP,88087,BJP,61825,2134,26262,12.27
348,Nizamabad,SP,67274,BSP,48745,1243,18529,11.06
349,Phoolpur Pawai,BJP,68435,BSP,61140,1609,7295,4.09
350,Didarganj,BSP,62125,SP,58480,1653,3645,1.94
351,Lalganj,BSP,72715,BJP,70488,2123,2227,1.09
352,Mehnagar,SP,69037,Suheldev Bhartiya Samaj Party,63625,2492,5412,2.68
353,Madhuban,BJP,86238,INC,56823,683,29415,13.73
354,Ghosi,BJP,88298,BSP,81295,1585,7003,2.9
355,Muhammadabad- Gohna (SC),BJP,73493,BSP,72955,1945,538,0.25
356,Mau,BSP,96793,Suheldev Bhartiya Samaj Party,88095,1725,8698,3.27
357,Belthara Road,BJP,77504,SP,59185,1305,18319,9.65
358,Rasara,BSP,92272,BJP,58385,1558,33887,17.54
359,Sikanderpur,BJP,69536,SP,45988,1122,23548,14.3
360,Phephana,BJP,70588,BSP,52691,1473,17897,10.02
361,Ballia Nagar,BJP,92889,SP,52878,1716,40011,21.52
362,Bansdih,SP,51201,IND,49514,918,1687,0.8
363,Bairia,BJP,64868,SP,47791,762,17077,10.53
364,Badlapur,BJP,60237,BSP,57865,1612,2372,1.24
365,Shahganj,SP,67818,Suheldev Bhartiya Samaj Party,58656,1473,9162,4.28
366,Jaunpur,BJP,90324,INC,78040,1939,12284,5.45
367,Malhani,SP,69351,Nirbal Indian Shoshit Hamara Aam Dal,48141,1707,21210,10.21
368,Mungra Badshahpur,BSP,69557,BJP,63637,2240,5920,2.9
369,Machhlishahr S.C.,SP,72368,BJP,68189,2165,4179,2.01
370,Mariyahu,Apna Dal (Soneylal),58804,SP,47454,1174,11350,6.3
371,Zafrabad,BJP,85989,SP,61124,1198,24865,12.04
372,Kerakat S.C.,BJP,84078,SP,68819,2557,15259,6.72
373,Jakhanian,Suheldev Bhartiya Samaj Party,84158,SP,79001,1837,5157,2.14
374,Saidpur,SP,76664,BJP,67954,1787,8710,4.09
375,Ghazipur,BJP,92090,SP,59483,1479,32607,15.27
376,Jangipur,SP,71441,BJP,68202,1109,3239,1.51
377,Zahoorabad,Suheldev Bhartiya Samaj Party,86583,BSP,68502,1500,18081,7.84
378,Mohammadabad,BJP,122156,BSP,89429,2283,32727,14.22
379,Zamania,BJP,76823,BSP,67559,1857,9264,4.26
380,Mughalsarai,BJP,87401,SP,74158,1950,13243,5.69
381,Sakaldiha,SP,79875,BJP,64906,1787,14969,7.4
382,Saiyadraja,BJP,78869,BSP,64375,1463,14494,7.33
383,Chakia,BJP,96890,BSP,76827,3162,20063,8.55
384,Pindra,BJP,90614,BSP,53765,2889,36849,18.03
385,Ajagara,Suheldev Bhartiya Samaj Party,83778,SP,62429,2350,21349,9.71
386,Shivpur,BJP,110453,SP,56194,812,54259,23.81
387,Rohaniya,BJP,119885,SP,62332,2190,57553,24.62
388,Varanasi North,BJP,116017,INC,70515,1115,45502,19.98
389,Varanasi South,BJP,92560,INC,75334,457,17226,9.63
390,Varanasi Cantt.,BJP,132609,INC,71283,758,61326,26.94
391,Sevapuri,Apna Dal (Soneylal),103423,SP,54241,1626,49182,23.82
392,Bhadohi,BJP,79519,SP,78414,830,1105,0.46
393,Gyanpur,Nirbal Indian Shoshit Hamara Aam Dal,66448,BJP,46218,1034,20230,9.68
394,Aurai,BJP,83325,SP,63546,2480,19779,9.6
395,Chhanbey,Apna Dal (Soneylal),107007,BSP,43539,4397,63468,29.41
396,Mirzapur,BJP,109196,SP,51784,1327,57412,25.49
397,Majhawan,BJP,107839,BSP,66680,1655,41159,17.14
398,Chunar,BJP,105608,SP,43380,2541,62228,28.73
399,Marihan,BJP,106517,INC,59919,2614,46598,19.55
400,Ghorawal,BJP,114305,SP,56656,5225,57649,24.12
401,Robertsganj,BJP,89932,SP,49394,1163,40538,19.93
402,Obra,BJP,78058,SP,33789,4305,44269,27.19
403,Duddhi,Apna Dal (Soneylal),64399,BSP,63314,8522,1085,0.55